10 10
......T...
XX...XX...
X.........
XXXXXXX...
....X.....
XX..X.X...
....XXX...
XX...XX.K.
S.........
XX...XX..G