10 10
S.....T...
XX...XX...
X.........
XXXXXXX...
....X.....
XX..X.X...
....XXX...
XX...XX.K.
..........
XX...XX.GG
