10 10
SK...T....
XX...XX...
X.........
XX.XXXX...
....X.....
XXXXX.X...
.G..XXX...
XX...XX...
......X..G
XX...XX..G
