10 10
G.....T..G
XX...XX...
X.........
XX.XXXX...
....X.....
XX..XGX...
....XXX..X
XX...XX.K.
S.........
XX...XX...