10 10
......T...
XX...XX...
X.........
XXXXXXX...
....X.....
XX..XSX...
....XXX...
XX...XX.K.
.........G
XX...XX..G
