10 10
......T...
XX...XX...
X.........
XX.XXXX...
....XG....
XX..XGX...
....XXX..X
XX...XX.K.
S.........
XX...XX...