10 10
......T...
XX...XX...
X.........
XXXXXXX...
....XG....
XX..XGX...
....XXXXXX
XX...XX.K.
S.........
XX...XX...